NO ./img/eagle.xpm
SO ./img/colorstone.xpm
WE ./img/greystone.xpm
EA ./img/redbrick.xpm

F 10,230,0
C 10,150,220

111111111111111111111111
100000000111111111111111
100000000100000011000011
101000000101100111010011
111111111011000111010011
101100000000000000010001
101111000000000000010001
100000000000000000011111
100000000000000000000001
100001010000000000000001
100001010000000000000001
100001110001100000000001
10000000000N00000000001
100000000001000000111101
100000110000000000100101
100000110000000000101101
100000000000000000001001
100000000000000001001001
100001111111000001111111
100000100110110000000001
100000100110100000000001
100000000100100000000001
100000000011100000000001
111111111111111111111111
